S................#
.......##.........
.................#
............####.#
.#.#...........#.#
...............#.#
.#.#.#.......#.#.#
.#.#############.#
..........G....#.#