S..............................
..............................#
.####.#.#####################.#
....#.#...#.................#.#
..#######.###.#############.#.#
..#.....#.#...#...........#...#
#.#.###.#.#.#####.#######.#.###
#...#...#.#.#.....#.......#...#
#.#######.###.#####.#########.#
#.#.........#...#...#.........#
#.###.###.#####.#.#.#.#######.#
#.#...#...#.....#.#.#...#.....#
#.#.###.#.#######.#.###.#.###.#
#...#...#.........#...#...#...#
..................###.#####.#.#
#...............#...#.......#.#
#.###.###########.#####.#####.#
#.#...#...........#.....#.....#
#.###.#########.###.###.###.#.#
#.....#.......#.....#...#...#.#
#.#######.###.#####.#.###.#.#.#
#.#.......#...#.....#...#...#.#
#.#.#######.#.#####.#####.###.#
#.#.#.....#.#...#.........#.#.#
#.###.#.###.###.#.#######.#.#.#
#...#.#.#.....#.#...#.......#.#
###.#.#.###.###.#####.#####.#.#
#...#...#...#...#...#.#.....#.#
#.#########.#####.#.#.#...G...#
###############################