S#..................################################
####################.###############################
.#.#..............#.#.............................#.
.#.#.############.#.#.###########################.#.
.#.#.#..........#.#.#.#.......................#.#.#.
.#.#.#.########.#.#.#.#.#####################.#.#.#.
.#.#.#.#......#.#.#.#.#.#...................#.#.#.#.
.#.#.#.#.####.#.#.#.#.#.#.################.#.#.#.#..
.#.#.#.#.#..#.#.#.#.#.#.#.#..............#.#.#.#.#..
.#.#.#.#.#.##.#.#.#.#.#.#.#.############.#.#.#.#.#..
.#.....#.#....#.....#...#...#...........#.#.#...#...
.#######.#######.#####.#####.#########.#.#.#.###....
#...#...#.#.....#.......#...#.#.......#.#...#...#...
.#.###.#.#.#########.#####.#.#.#.#####.#.#######.#..
.#.#..G#...#.........#...#.#.#.#.#.....#.......#.#..
.#.####.###.###########.#.#.###.#.###########.#.#...
.#....#.#...#.........#.#.....#...#.........#.#.#...
.####.#.#.#########.###.#######.#########.###.#.....
#...#.#.#.......#...#.......#...........#.....#.#...
.#.###.#########.#####.#####.###########.#####.#....
.#.#..........#...#...#.#...#...#.......#...#.#.#...
.#.#.##########.#####.#.#.#.###.#.#####.###.#.#.#...
.#.#.#........#.......#.#.#...#.#.#.....#...#.#.#...
.#.#.#.########.#######.#####.#.#.#.#######.#.#.#...
.#.#.#.#......#.#.....#.#...#...#.#.#.......#.#.#...
.#.#.#.#.####.#.#.#####.#.###.#####.#.#######.#.#...
.#.#.#.#.#..#.#.#.#...#.#.#.#.#...#.#.#.......#.#...
.#.#.#.#.#.##.#.#.#.#.#.###.#.#.#.#.#.#########.#...
.#.....#.#....#...#.#...#...#.#.#.#.#...........#...
.#######.#######.###.#####.#.#.#.#.#.###########....
#.......#.........#.....#.#...#.#.#.#...........#...
.#####.#########.#######.#.#####.#.#############....
#...#.#.#.......#.......#.#.#...#.#.#...........#...
.#.#.#.#.#.#####.#######.#.#.#.#.#.#.###########....
.#.#.#.#.#.#..........#...#.#.#.#.#...#.......#.#...
.#.###.#.#.#.##########.#####.#.#.###.#.#####.#.#...
.#...#.#.#.#.#........#.#...#...#.#...#.#.....#.#...
.###.#.#.###.#.########.#.#######.#.###.#.#####.#...
#...#.#....#.#.#........#.#.......#...#.#.#.....#...
.###.#####.#.#.#.########.#########.###.#.###.###...
#...#......#...#.#........#.........#...#.#...#.#...
.###########.###.#.########.#########.#####.#.#.#...
#............#...#.#........#.......#.#.....#.#.#...
.############.#####.########.#####.#.#.#####.#.#....
#............#.#...#..........#...#.#.#.#.....#.#...
.############.#.#.############.###.#.#.#.###.#.#....
#...........#.#.#.#............#...#.#...#...#...#..
.###########.#.#.#.############.#####.#####.#####...
#............#...#..............#.....#.........G###
##################################################..