S.#########
..........#
.#.######.#
.#....#...#
.####.#.#.#
....G.#.#.#
#####.###.#
#.....#...#
###########