S..........
.#.........
..#........
...#.......
....#......
.....#.....
......#....
.......#...
........#..
.........G.
