S#########
.........#
#########.
.........#
.#########
.........#
#########.
.........#
.#########
.........G
